"","RLE_EPL24","Depression","Floodplain","Seep","Unchannelled valley-bottom","Total"
"1","LC_WP",1,1,3,0,5
"2","LC_MP",0,0,1,3,4
"3","VU_WP",1,1,0,0,2
"4","VU_MP",1,0,0,2,3
"5","LC_PP",2,4,5,4,15
"6","LC_NP",1,2,2,1,6
"7","VU_PP",3,5,3,1,12
"8","VU_NP",2,1,1,2,6
"9","EN_WP",2,0,0,0,2
"10","EN_MP",1,1,1,0,3
"11","CR_WP",1,0,0,0,1
"12","CR_MP",0,0,1,0,1
"13","EN_PP",3,3,0,4,10
"14","EN_NP",0,1,2,2,5
"15","CR_PP",3,0,0,0,3
"16","CR_NP",1,0,1,0,2
"17","Total",22,19,20,19,80
