"","ETS_EPL24","Floodplain","Seep","Depression","Unchannelled valley-bottom","Total"
"1","LC_WP",2,2,0,0,4
"2","LC_MP",1,2,5,4,12
"3","LC_PP",6,5,11,7,29
"4","LC_NP",1,1,4,2,8
"5","EN_MP",0,2,0,0,2
"6","EN_PP",3,3,0,2,8
"7","EN_NP",1,1,1,0,3
"8","CR_PP",3,0,0,1,4
"9","CR_NP",2,4,1,3,10
"10","Total",19,20,22,19,80
