"","RLE_EPL24","Floodplain","Seep","Depression","Unchannelled valley-bottom","Total"
"1","LC_WP",1,2,0,0,3
"2","LC_MP",0,2,2,4,8
"3","VU_WP",1,0,0,0,1
"4","VU_MP",0,0,3,0,3
"5","LC_PP",3,6,8,5,22
"6","LC_NP",2,2,3,1,8
"7","VU_PP",7,2,1,3,13
"8","VU_NP",1,2,2,1,6
"9","EN_MP",1,1,0,0,2
"10","CR_MP",0,1,0,0,1
"11","EN_PP",2,0,2,3,7
"12","EN_NP",1,2,1,3,7
"13","Total",19,20,22,20,81
