"","ETS_EPL24","Floodplain","Seep","Unchannelled valley-bottom","Depression","Total"
"1","LC_WP",2,2,0,0,4
"2","LC_MP",1,2,4,0,7
"3","VU_MP",0,0,0,2,2
"4","LC_PP",4,7,6,5,22
"5","LC_NP",2,2,1,1,6
"6","VU_PP",1,0,0,1,2
"7","VU_NP",0,0,1,1,2
"8","EN_MP",0,2,0,1,3
"9","CR_MP",0,0,0,2,2
"10","EN_PP",4,1,4,3,12
"11","EN_NP",0,1,0,2,3
"12","CR_PP",3,0,1,2,6
"13","CR_NP",2,3,3,2,10
"14","Total",19,20,20,22,81
