"","RLE_EPL24","Depression","Seep","Unchannelled valley-bottom","Floodplain","Total"
"1","LC_WP",1,1,0,0,2
"2","LC_MP",0,2,2,0,4
"3","VU_WP",1,1,0,1,3
"4","VU_MP",1,0,1,0,2
"5","LC_PP",1,3,4,2,10
"6","LC_NP",0,2,0,3,5
"7","VU_PP",0,5,3,4,12
"8","VU_NP",2,2,1,2,7
"9","EN_WP",0,0,0,1,1
"10","EN_MP",1,1,0,1,3
"11","CR_WP",3,0,0,0,3
"12","CR_MP",0,1,0,0,1
"13","EN_PP",3,0,3,4,10
"14","EN_NP",0,2,5,1,8
"15","CR_PP",8,0,1,0,9
"16","CR_NP",1,1,0,0,2
"17","Total",22,21,20,19,82
