"","RLE_EPL24","Floodplain","Seep","Unchannelled valley-bottom","Depression","Total"
"1","LC_WP",1,2,0,0,3
"2","LC_MP",0,2,4,0,6
"3","VU_WP",1,0,0,0,1
"4","VU_MP",0,0,0,4,4
"5","LC_PP",3,6,5,6,20
"6","LC_NP",2,2,1,2,7
"7","VU_PP",6,2,3,3,14
"8","VU_NP",1,2,1,2,6
"9","EN_MP",1,1,0,1,3
"10","CR_MP",0,1,0,0,1
"11","EN_PP",3,0,3,2,8
"12","EN_NP",1,2,3,1,7
"13","CR_NP",0,0,0,1,1
"14","Total",19,20,20,22,81
