"","RLE_EPL24","Floodplain","Seep","Unchannelled valley-bottom","Depression","Total"
"1","LC_WP",2,2,0,0,4
"2","LC_MP",0,3,3,0,6
"3","VU_MP",1,0,1,3,5
"4","LC_PP",5,7,8,5,25
"5","LC_NP",2,4,3,4,13
"6","VU_PP",7,1,3,3,14
"7","VU_NP",2,1,2,1,6
"8","EN_MP",0,1,0,1,2
"9","CR_MP",0,0,0,1,1
"10","EN_PP",0,0,0,3,3
"11","EN_NP",0,1,0,1,2
"12","Total",19,20,20,22,81
