"","RLE_EPL24","Floodplain","Seep","Unchannelled valley-bottom","Depression","Total"
"1","LC_WP",1,2,0,0,3
"2","LC_MP",0,2,3,0,5
"3","VU_WP",1,0,0,0,1
"4","VU_MP",0,0,1,1,2
"5","LC_PP",4,6,4,3,17
"6","LC_NP",2,1,1,1,5
"7","VU_PP",5,2,3,2,12
"8","VU_NP",1,2,1,4,8
"9","EN_MP",1,1,0,3,5
"10","CR_MP",0,1,0,1,2
"11","EN_PP",3,0,3,3,9
"12","EN_NP",1,2,3,0,6
"13","CR_PP",0,0,0,3,3
"14","CR_NP",0,1,0,1,2
"15","Total",19,20,19,22,80
